11111111111111111111111
1P00000000C00000000X001
10000000000000000000001
100C000000000000C000001
10011111100001000010001
10010000000001000010001
10010000000001000010001
1001000000C00100001X001
10010001000001000010001
10011111100001111110001
10000001000000000000001
1000000000X000000000001
10000000C00000000000001
1000000000000000X000001
10000000000E00000000001
11111111111111111111111