11111111111111111111
1P00000000C000000001
10000000111111110111
100C000000X00000C001
10000000000000000001
10000000000000000001
10000000000000000001
10000000000000000001
100000000000C0000001
11111111111100000001
10000000000000000001
1X00000C000000000001
10000000000000000001
1000000000000000X001
10000C000000E0000001
11111111111111111111