11111111111111111111111
1P00000000C0000000000X1
10000000000000000000001
100C000000000000C000001
10011111100001000010001
10010000000001000010001
10010000000001000010001
1001000000C001000010001
100100010000010X0010001
1X011111100001111110001
10000001000000000000001
10000000000000000000001
10000000C00000000000001
100000000000000000X0001
10000000000E00000000001
11111111111111111111111