11111111111111111111
1P00000000C000000001
10000000111111111111
100C000000X00000C001
100000000000C0000001
11111111111100000001
10000000000000000001
10000C000000000000E1
11111111111111111111